█, ,M,17,9,40
██████████████████████████████████████
██       ████    ██                 ██
██         ██     ██      ██████    ██
██   █     ██    ██     ███         ██
██   █      ██    ██  ███           ██
██   ██      █               ██     ██
██   ██                     ██      ██
██    ██████████      ███████       ██
██          ██                      ██
██          ██       ███            ██
██   ██                ███     ███████
██    ██████████        █      ██S^S██
██            ██        █      ██<S>██
██            ██       ███     ██SVS██
██████████████████████████████████████