######################################
#            #mEmE#      #/.........\#
#   #        ######      #\........./#
#   #                    #############
#       #         #                  #
#       #       ###                  #
#       #         ##############     #
####    #########                    #
#            #    #                  #
#   #        #    #         ######   #
#   #             #         #        #
#       #         #         #        #
#       #       ######################
#       #       #STUDY+DYING=STUDYING#
######################################