##########################            
#            #Дада#      #            
#   #        ######      #            
#   #                    ###########  
#       #         #                ## 
#       #       ###                 # 
#       #         ##############    ##
####    #########                    #
   #         #    #                  #
   ##        #    #         ######   #
    #             #         #        #
     ###          #         #        #
        #       ######################
        #       #STUDY+DYING=STUDYING#
        ##############################